SO ./img/stone.xpm


NO ./img/mossy.xpm


WE ./img/purple.xpm
EA ./img/brick.xpm

F 35,35,35
C 0, 35 ,35

11111111111111111111111111111111111111111111111111
10000000000000000000000000000000000000000000000001
10000000000000000000003330000000000000000000000001
10000000000000000000000000000000000000000000000001
10000N00000000000000000000000000000000000000000001
10000000000000000011111111000000000000000000000001
1000000000000000001      1000000000000000000000001
1000000000000000001  1   1000000000000000000000001
1000000000000000001      1000000000000000000000001
10000000000000000011111111000000000000000000000001
10000000000000000000000000000000000000000000000001
10000000000000000000000000000000000000000000000001
10000000000000000000000000000000000000000000000001
10000000000000000000000000000000000000000000000001
10000000000000000000000000000000000000000000000001
10000000000000000000000000000000000000000000000001
10000000000000000000000000000000000000000000000001
10000000000000000000000000000000000000000000000001
10000000000000000000000000000000000000000000000001
10000000000000000000000000000000000000000000000001
11111111111111111111111111111111111111111111111111
