SO ./img/stone.xpm
NO ./img/mossy.xpm
N1 ./img/purple.xpm
N2 ./img/purple.xpm
N3 ./img/purple.xpm
WE ./img/purple.xpm
EA ./img/brick.xpm

F 35,35,0
C 0, 35 ,35

11111111111111111111111111111111111111111111111111
10000000000000000000000000000000000000000000000001
10000000000000000000003330000000000000000000000001
10000000000000000000000000000000000000000000000001
10000000000000000030000N00030000000000000000000001
10000000000000000000000000000000000000000000000001
10000000000000000000000000000000000000000000000001
10000000333330000000000000000000000000000000000001
10000000000000000000000000000000000000000000000001
10000000000000000000000000000000000000000000000001
10000000000000000000000000000000000000000000000001
10000000000000000011111111000000000000000000000001
1000000000000000001      1000000000000000000000001
1000000000000000001      1000000000000000000000001
1000000000000000001      1000000000000000000000001
10000000000000000011111111000000000000000000000001
10000000000000000000000000000000000000000000000001
10000000000000000000000000000000000000000000000001
10000000000000000000000000000000000000000000000001
10000000000000000000000000000000000000000000000001
10000000000000000000000000000000000000000000000001
10000000000000000000000000000000000000000000000001
10000000000000000000000000000000000000000000000001
10000000000000000000000000000000000000000000000001
10000000000000000000000000000000000000000000000001
10000000000000000000000000000000000000000000000001
11111111111111111111111111111111111111111111111111
