1111111111111111111111111111111111
100000M00P00000C00000C000000E00M01
1111111111111111111111111111111111
